checkMissingData	FALSE
maxBlockSize	15000
blockSizePenaltyPower	5
nPreclusteringCenters	20
randomSeed	12345
loadTOM	FALSE
corType	bicor
maxPOutliers	1
quickCor	0
pearsonFallback	individual
cosineCorrelation	FALSE
power	13
networkType	signed
replaceMissingAdjacencies	FALSE
suppressTOMForZeroAdjacencies	FALSE
TOMType	signed
TOMDenom	min
saveTOMs	FALSE
saveTOMFileBase	blockwiseTOM
deepSplit	2
detectCutHeight	0.995
minModuleSize	20
useBranchEigennodeDissim	FALSE
minBranchEigennodeDissim	0.15
stabilityCriterion	Individual fraction
pamStage	TRUE
pamRespectsDendro	TRUE
reassignThreshold	1e-06
minCoreKME	0.5
minCoreKMESize	7
minKMEtoStay	0.3
mergeCutHeight	0.15
impute	TRUE
trapErrors	FALSE
numericLabels	FALSE
nThreads	8
useInternalMatrixAlgebra	FALSE
useCorOptionsThroughout	TRUE
verbose	0
indent	0
